111111111111
100100C0C0E1
1N0C01N01111
100000001001
11000N1000P1
100000000001
101010101011
111111111111