111111111111
100010C000E1
100C10000011
100010000001
11000010N0P1
100000000001
101010101011
111111111111