111111
100001
111C11
101E11
1100P1
111111
